Agaricus_augustus-b	NA
Agaricus_augustus	0
Agaricus_bisporus	0
Agaricus_crocopeplus-a	NA
Agaricus_crocopeplus-b	NA
Agaricus_perobscurus	NA
Agaricus_purpurellus	NA
Agaricus_rotalis-b	NA
Agaricus_rotalis	NA
Agaricus_trisulphuratus-b	NA
Agaricus_trisulphuratus-c	NA
Agaricus_trisulphuratus-d	NA
Agaricus_trisulphuratus-e	NA
Agaricus_trisulphuratus	NA
Albatrellus_flettii	NA
Albatrellus_ovinus	NA
Aleuria_aurantia-b	NA
Aleuria_aurantia-c	NA
Aleuria_aurantia	NA
Aleuria_rhenana	NA
Am_hemibapha_v_similis	NA
Am_muscaria_v_formosa-b	NA
Amanita_abrupta	1
Amanita_aff_longistriata	NA
Amanita_banningiana-b	NA
Amanita_banningiana	NA
Amanita_bisporigera-b	NA
Amanita_bisporigera-c	NA
Amanita_bisporigera	1
Amanita_flavoconia	1
Amanita_franchetii-b	NA
Amanita_franchetii-c	NA
Amanita_franchetii	NA
Amanita_fulva	0
Amanita_hemibapha-b	NA
Amanita_hemibapha	0
Amanita_ibotengutake	NA
Amanita_jacksonii-b	NA
Amanita_jacksonii-c	NA
Amanita_jacksonii-d	NA
Amanita_jacksonii	1
Amanita_lanei	1
Amanita_lanei_white_form	NA
Amanita_magniverrucata	NA
Amanita_marmorata	NA
Amanita_muscaria-b	NA
Amanita_muscaria-c	NA
Amanita_muscaria-d	NA
Amanita_muscaria-e	NA
Amanita_muscaria-f	NA
Amanita_muscaria	1
Amanita_muscaria_v_formosa	NA
Amanita_ocreata	1
Amanita_onusta	NA
Amanita_pantherina	1
Amanita_parcivolvata-b	NA
Amanita_parcivolvata	1
Amanita_phalloides-b	NA
Amanita_phalloides-c	NA
Amanita_phalloides-e	NA
Amanita_phalloides	1
Amanita_phalloides_v_alba	NA
Amanita_rubescens-f	NA
Amanita_rubescens	1
Amanita_rubrovolvata-b	NA
Amanita_rubrovolvata-c	NA
Amanita_rubrovolvata	1
Amanita_sp-b	NA
Amanita_sp-c	NA
Amanita_sp-d	NA
Amanita_sp-e	NA
Amanita_sp-f	NA
Amanita_sp-g	NA
Amanita_sp-h	NA
Amanita_sp-i	NA
Amanita_sp-k	NA
Amanita_sp-l	NA
Amanita_sp-t	NA
Amanita_sp	NA
Amanita_virgineoides-b	NA
Amanita_virgineoides-c	NA
Amanita_virgineoides	NA
Amanita_virosa	1
Anthracophyllum_melano	NA
Anthrocophyllum_sp	NA
Arcangeliella_variegata	NA
Armillaria_luteobubalina	0
Artomyces_pyxidatus	0
Ascocoryne_sarcoides	NA
Aseroe_rubra-b	NA
Aseroe_rubra-c	NA
Aseroe_rubra-d	NA
Aseroe_rubra	NA
Asterophora_parasitica-b	NA
Asterophora_parasitica	NA
Astraeus_hygrometricus-b	NA
Astraeus_hygrometricus	0
Astraeus_pteridis	NA
Aureoboletus_reticuloceps	NA
Aureoboletus_thibetanus-b	NA
Aureoboletus_thibetanus-c	NA
Aureoboletus_thibetanus	NA
Auricularia_delicata	NA
Auricularia_polytricha	NA
Auriscalpium_vulgare-b	NA
Auriscalpium_vulgare-c	NA
Auriscalpium_vulgare-d	NA
Auriscalpium_vulgare-e	NA
Auriscalpium_vulgare	NA
Austroboletus_betula-b	NA
Austroboletus_betula-c	NA
Austroboletus_betula	NA
Austroboletus_gracilis	NA
Austroboletus_niveus	NA
Austroboletus_occidentalis	NA
Austropaxillus_macnabbii	NA
Badhamia_utricularis-b	NA
Badhamia_utricularis	NA
Battarrea_japonica-b	NA
Battarrea_japonica	NA
Bolbitius_vitellinus	NA
Boletellus_ananas	NA
Boletellus_emodensis-b	NA
Boletellus_emodensis-c	NA
Boletellus_emodensis-d	NA
Boletellus_emodensis	NA
Boletellus_obscure-b	NA
Boletellus_obscure	NA
Boletellus_russelli	NA
Boletellus_sp	NA
Boletinellus_rompelii	NA
Boletus_aereus	0
Boletus_auripes-b	NA
Boletus_auripes	0
Boletus_bicolor	NA
Boletus_edulis-b	NA
Boletus_edulis-c	NA
Boletus_edulis-d	NA
Boletus_edulis-e	NA
Boletus_edulis-f	NA
Boletus_edulis-g	NA
Boletus_edulis-h	NA
Boletus_edulis-i	NA
Boletus_edulis-j	NA
Boletus_edulis	0
Boletus_frosti-c	NA
Boletus_frostii-b	NA
Boletus_frostii-d	NA
Boletus_frostii	NA
Boletus_hortonii	NA
Boletus_mirabilis	NA
Boletus_pulcherrimus	1
Boletus_smithii	NA
Boletus_sp-b	NA
Boletus_sp-c	NA
Boletus_sp	NA
Boletus_stromenium	NA
Boletus_subvelutipes	NA
Boletus_zelleri-b	NA
Boletus_zelleri	NA
Bondarzewia_berkeleyi-b	NA
Bondarzewia_berkeleyi	NA
Bulgaria_inquinans-b	NA
Bulgaria_inquinans	NA
Calostoma_cinnabarina-b	NA
Calostoma_cinnabarina	NA
Calostoma_insignis	NA
Calvatia_bovista	NA
Camillea_leprieurii	NA
Campanella_aeruginea	NA
Cantha_cinnabarinus-j	NA
Cantha_cinnabarinus-k	NA
Cantha_cinnabarinus	NA
Cantharellus_cibarius-b	NA
Cantharellus_cibarius-c	NA
Cantharellus_cibarius-d	NA
Cantharellus_cibarius-e	NA
Cantharellus_cibarius-f	NA
Cantharellus_cibarius-g	NA
Cantharellus_cibarius-h	NA
Cantharellus_cibarius	0
Cantharellus_formosus-b	NA
Cantharellus_formosus-c	NA
Cantharellus_formosus	0
Cantharellus_persicinus	0
Cantharellus_sp-b	NA
Cantharellus_sp-c	NA
Cantharellus_sp	NA
Cantharellus_subalbidus-b	NA
Cantharellus_subalbidus	0
Caripia_montagnei	NA
Ceratiomyxa_fruticulosa	NA
Chalciporus_rubinellus	NA
Chloro_aeruginascens	NA
Chlorociboria_aeruginosa-b	NA
Chlorociboria_aeruginosa	NA
Chlorophyllum_brunneum-b	NA
Chlorophyllum_brunneum-c	NA
Chlorophyllum_brunneum	1
Chroogomphus_rutilus	0
Chrysomphalina_aurantiaca	NA
Clathrus_archeri-b	NA
Clathrus_archeri	NA
Clathrus_chrysomycelinus-b	NA
Clathrus_chrysomycelinus	NA
Clathrus_columnatus	NA
Clathrus_crispus-b	NA
Clathrus_crispus	NA
Clathrus_pusillus-b	NA
Clathrus_pusillus	NA
Clathrus_ruber-b	NA
Clathrus_ruber	NA
Clathrus_sp	NA
Clavaria_zollingeri-b	NA
Clavaria_zollingeri	NA
Clavariadel_occidentalis	NA
Clavariadelphus_truncatus	0
Clavulinopsis%20fusiformis-b	NA
Clavulinopsis_fusiformis	NA
Climacodon_roseo-b	NA
Climacodon_roseo-c	NA
Climacodon_roseomaculatus	NA
Climacodon_septentrionale	NA
Clitocybe_nudum	NA
Clitocybe_odora	0
Clitocybe_sp	NA
Clitocybula_azurea	NA
Clitopilus_prunulus	0
Coniolepiota_sp-b	NA
Coniolepiota_sp	NA
Coniolepiota_spongodes-b	NA
Coniolepiota_spongodes	NA
Cookeina_colensoi	NA
Cookeina_sp	NA
Cookeina_speciosa	NA
Cookeina_sulcipes-b	NA
Cookeina_sulcipes-c	NA
Cookeina_sulcipes-d	NA
Cookeina_sulcipes-e	NA
Cookeina_sulcipes-f	NA
Cookeina_sulcipes-g	NA
Cookeina_sulcipes-h	NA
Cookeina_sulcipes-i	NA
Cookeina_sulcipes	NA
Cookeina_tricholoma-b	NA
Cookeina_tricholoma-c	NA
Cookeina_tricholoma-d	NA
Cookeina_tricholoma-e	NA
Cookeina_tricholoma-f	NA
Cookeina_tricholoma-g	NA
Cookeina_tricholoma-h	NA
Cookeina_tricholoma	NA
Coprinellus_micaceus	0
Coprinellus_micaceus_neg	NA
Coprinellus_sp	NA
Coprinopsis_acuminatus	NA
Coprinopsis_lagopus-b	NA
Coprinopsis_lagopus	NA
Coprinopsis_sp-b	NA
Coprinopsis_sp-c	NA
Coprinopsis_sp-e	NA
Coprinopsis_sp	NA
Coprinus_comatus-b	NA
Coprinus_comatus	0
Cordyceps_amazonicus-b	NA
Cordyceps_amazonicus	NA
Cordyceps_gunnii	NA
Cordyceps_nutans-b	NA
Cordyceps_nutans	NA
Cordyceps_sinensis-b	NA
Cordyceps_sinensis-c	NA
Cordyceps_sinensis-d	NA
Cordyceps_sinensis	NA
Cordyceps_sp-b	NA
Cordyceps_sp-c	NA
Cordyceps_sp-d	NA
Cordyceps_sp-e	NA
Cordyceps_sp-f	NA
Cordyceps_sp-g	NA
Cordyceps_sp-h	NA
Cordyceps_sp-i	NA
Cordyceps_sp-j	NA
Cordyceps_sp-k	NA
Cordyceps_sp-l	NA
Cordyceps_sp	NA
Cort_vanduzerensis-b	NA
Cort_vanduzerensis-c	NA
Cort_vanduzerensis-d	NA
Cort_vanduzerensis-e	NA
Cort_vanduzerensis-f	NA
Cort_vanduzerensis-g	NA
Cortinarius_archeri-b	NA
Cortinarius_archeri	NA
Cortinarius_armilatus	NA
Cortinarius_armillatus	NA
Cortinarius_austrovenetus	NA
Cortinarius_bolaris	NA
Cortinarius_iodes-b	NA
Cortinarius_iodes-c	NA
Cortinarius_iodes	0
Cortinarius_magellanicus-b	NA
Cortinarius_magellanicus	NA
Cortinarius_sp-b	NA
Cortinarius_sp-c	NA
Cortinarius_sp-d	NA
Cortinarius_sp	NA
Cortinarius_traganus	NA
Cortinarius_vanduzerensis	NA
Cortinarius_violaceus-b	NA
Cortinarius_violaceus	0
Craterellus_aurora	NA
Craterellus_cornu-b	NA
Craterellus_cornu-c	NA
Craterellus_cornucopioides	0
Craterellus_fallax	NA
Craterellus_odoratus-b	NA
Craterellus_odoratus	NA
Craterellus_ordoratus	NA
Crepidotus_sp-b	NA
Crepidotus_sp-c	NA
Crepidotus_sp	NA
Cryptoporus_volvatus-b	NA
Cryptoporus_volvatus	NA
Cymatoderma_elegans	NA
Cyptotrama_asprata-b	NA
Cyptotrama_asprata-c	NA
Cyptotrama_asprata	NA
Cystoderma_sp	NA
Cystolepiota_sp-b	NA
Cystolepiota_sp	NA
Daedaleopsis_confragosa	NA
Deflexula_sp	NA
Deflexula_subsimplex	NA
Dermocybe_austroveneta	NA
Deviled_eggs	NA
Dictyophora_cinnabarina-b	NA
Dictyophora_cinnabarina	NA
Dictyophora_duplicata	NA
Dictyophora_indusiata-b	NA
Dictyophora_indusiata-c	NA
Dictyophora_indusiata-d	NA
Dictyophora_indusiata-e	NA
Dictyophora_indusiata-f	NA
Dictyophora_indusiata	NA
Dictyophora_mulitcolor	NA
Dictyophora_multicolor-b	NA
Dictyophora_multicolor-c	NA
Dictyophora_multicolor-d	NA
Dictyophora_multicolor-e	NA
Dictyophora_multicolor	NA
Dictyophora_sp	NA
Durianella_echinulata-b	NA
Durianella_echinulata-c	NA
Durianella_echinulata	NA
Elaphocordyceps_capitata	NA
Elaphocordyceps_sp	NA
Entoloma_bloxami	NA
Entoloma_incanum	NA
Entoloma_sp	NA
Entoloma_virescens-b	NA
Entoloma_virescens-c	NA
Entoloma_virescens	NA
Exidia_recisa	NA
Favolaschia_calocera	NA
Favolaschia_pustulosa-b	NA
Favolaschia_pustulosa-c	NA
Favolaschia_pustulosa	NA
Favolaschia_sp	NA
Filoboletus_manipularis-b	NA
Filoboletus_manipularis-c	NA
Filoboletus_manipularis	NA
Fistulina_aff_hepatica-b	NA
Fistulina_aff_hepatica	NA
Fistulina_hepatica-b	NA
Fistulina_hepatica-c	NA
Fistulina_hepatica-d	NA
Fistulina_hepatica	0
Fistulinella_mollis	NA
Flabellophora_obovata-b	NA
Flabellophora_obovata	NA
Flammulina_velutipes-b	NA
Flammulina_velutipes-c	NA
Flammulina_velutipes	NA
Fomitopsis_pinicola	NA
Fomitopsis_sp	NA
G_juniperi-virginianae	NA
Galerina_autumnalis	NA
Galerina_marginata	1
Galerina_patagonica	NA
Gallacea_scleroderma	NA
Ganoderma_lucidum-b	NA
Ganoderma_lucidum-c	NA
Ganoderma_lucidum-d	NA
Ganoderma_lucidum-e	NA
Ganoderma_lucidum	NA
Ganoderma_sp-b	NA
Ganoderma_sp	NA
Ganoderma_tsugae	NA
Geastrum_minimum	NA
Geastrum_sp-b	NA
Geastrum_sp	NA
Gerronema_retiarium	NA
Gerronema_strombodes	NA
Gerronema_viridilucens-b	NA
Gerronema_viridilucens-c	NA
Gerronema_viridilucens-d	NA
Gerronema_viridilucens-e	NA
Gerronema_viridilucens-f	NA
Gerronema_viridilucens	NA
GillShotMaster	NA
Glaziella_vesiculosa	NA
Gliophorus_graminicolor	NA
Gliophorus_sp-b	NA
Gliophorus_sp-c	NA
Gliophorus_sp	NA
Golden_Chanterelles	NA
Gomphidius_subroseus	NA
Gomphus_clavatus-b	NA
Gomphus_clavatus	0
Gomphus_floccosus-b	NA
Gomphus_floccosus	NA
Gomphus_kauffmanii-c	NA
Gomphus_kauffmanii	NA
Gomphus_sp-b	NA
Gomphus_sp	NA
Grifola_frondosa-b	NA
Grifola_frondosa-c	NA
Grifola_frondosa-d	NA
Grifola_frondosa-e	NA
Grifola_frondosa	0
Grofola_frondosa	NA
Gymnopilus_spectabilis-b	NA
Gymnopilus_spectabilis	NA
Gymnopus_dryophilus	0
Gyrodon_merulioides-b	NA
Gyrodon_merulioides	NA
Gyromitra_caroliniana	NA
Gyromitra_esculenta	0
Gyromitra_gigas	NA
Gyromitra_infula-b	NA
Gyromitra_infula-c	NA
Gyromitra_infula	NA
Gyroporus_castaneus	0
Hebeloma_aminophilum	NA
Helvella_crispa	1
Helvella_lacunosa-b	NA
Helvella_lacunosa	0
Helvella_macropus-b	NA
Helvella_macropus	NA
Helvella_sp-b	NA
Helvella_sp	NA
Hemitrichia_sp	NA
Hericium_abietis-b	NA
Hericium_abietis-c	NA
Hericium_abietis	0
Hericium_coralloides-b	NA
Hericium_coralloides-c	NA
Hericium_coralloides-d	NA
Hericium_coralloides	NA
Hericium_erinaceus	0
Hericium_sp-b	NA
Hericium_sp-c	NA
Hericium_sp-d	NA
Hericium_sp	NA
Hohenbuehelia_mastrucata	NA
Hohenbuehelia_sp	NA
Hohenbuhelia_petaloides	NA
Humaria_hemisphaerica	NA
Hydnellum_caeruleum	NA
Hydnellum_peckii-b	NA
Hydnellum_peckii	NA
Hydnellum_sp-b	NA
Hydnellum_sp-c	NA
Hydnellum_sp	NA
Hydno_fimbriatus-b	NA
Hydnodon_thelephorus	NA
Hydnodon_thelophorus	NA
Hydnopolyporus_fimbriatus	NA
Hydnum_repandum-b	NA
Hydnum_repandum	0
Hydnum_sp	NA
Hygrocybe_coccinea-b	NA
Hygrocybe_coccinea-c	NA
Hygrocybe_coccinea	0
Hygrocybe_conica	NA
Hygrocybe_flavescens-b	NA
Hygrocybe_flavescens	NA
Hygrocybe_laeta-b	NA
Hygrocybe_laeta	NA
Hygrocybe_psittacina-b	NA
Hygrocybe_psittacina-c	NA
Hygrocybe_psittacina-d	NA
Hygrocybe_psittacina-e	NA
Hygrocybe_psittacina	NA
Hygrocybe_sp-b	NA
Hygrocybe_sp-c	NA
Hygrocybe_sp-d	NA
Hygrocybe_sp-e	NA
Hygrocybe_sp-f	NA
Hygrocybe_sp	NA
Hygrophoropsis_aurantiaca	NA
Hygrophorus_bakerensis	0
Hygrophorus_chrysodon	NA
Hygrophorus_fuligineus	NA
Hygrophorus_hypothejus	0
Hygrophorus_leucophaeus	NA
Hygrophorus_speciosus-b	NA
Hygrophorus_speciosus-c	NA
Hygrophorus_speciosus-d	NA
Hygrophorus_speciosus	NA
Hypholoma_capnoides	0
Hypholoma_fasciculare	1
Hypholoma_sp	NA
Hypomyces_aff_luteovirens	NA
Hypomyces_lactifluorum-b	NA
Hypomyces_lactifluorum-c	NA
Hypomyces_lactifluorum	0
Hypsizygus_tessellatus	0
Hypsizygus_ulmarius	NA
Inonotus_obliquus	NA
Inonotus_obliquus_SS07	NA
Inonotus_tomentosus	NA
Isaria_sp	NA
Laccaria_aff_amethystina	NA
Laccaria_amythestina	NA
Laccaria_sp	NA
Lachnocladium_cf_denudatum	NA
Lactarius_atroviridis	NA
Lactarius_fallax-b	NA
Lactarius_fallax	NA
Lactarius_indigo-b	NA
Lactarius_indigo	0
Lactarius_sp-b	NA
Lactarius_sp	NA
Lactarius_torminosus-b	NA
Lactarius_torminosus	0
Laetiporus_sulphureus-b	NA
Laetiporus_sulphureus-c	NA
Laetiporus_sulphureus	0
Leccinum_atrostipitatum	NA
Leccinum_scabrosum	NA
Leccinum_sp	NA
Leccinum_verispelle	NA
Lentinellus_cochleatus	NA
Lentinellus_montanus	NA
Lentinula_edodes-b	NA
Lentinula_edodes-c	NA
Lentinula_edodes	0
Lentinus_crinitus	NA
Lentinus_sp	NA
Lentinus_velutinus	NA
Lenzites_betulina	NA
Lenzites_sp	NA
Leotia_lubrica	NA
Leotia_sp	NA
Leotia_viscosa	NA
Lepiota_magnispora	NA
Lepiota_sp-b	NA
Lepiota_sp	NA
Lepista_sordida	0
Leptonia_carnea	NA
Leptonia_sp-c	NA
Leptonia_sp-d	NA
Leptonia_sp	NA
Leratiomyces_ceres-b	NA
Leratiomyces_ceres	NA
Leuco_fragilissimus	NA
Leucocoprinus_aff_fragili	NA
Leucocoprinus_cepaestipes	NA
Leucocoprinus_cretaceus-b	NA
Leucocoprinus_cretaceus	NA
Leucocoprinus_fragili-b	NA
Leucocoprinus_luteus	NA
Leucocoprinus_sp	NA
Linderia_columnata-b	NA
Linderia_columnata-c	NA
Linderia_columnata-d	NA
Linderia_columnata	NA
Lycoperdon_americanum-b	NA
Lycoperdon_americanum	NA
Lycoperdon_perlatum-b	NA
Lycoperdon_perlatum	0
Lycoperdon_sp	NA
Lyophyllum_fumosum	NA
Lyophyllum_shimeji	NA
Lysurus_coralocephala-b	NA
Lysurus_coralocephala	NA
Lysurus_mokusin-b	NA
Lysurus_mokusin	NA
Lysurus_periphragmoides	NA
Macrocybe_gigantea-b	NA
Macrocybe_gigantea-c	NA
Macrocybe_gigantea	NA
Macrolepiota_clelandii	NA
Macrolepiota_sp-b	NA
Macrolepiota_sp	NA
Macrotyphula_fistulosa	NA
Marasmiellus_cf_helmin	NA
Marasmiellus_cubensis-b	NA
Marasmiellus_cubensis	NA
Marasmiellus_nigripes	NA
Marasmius_elegans	NA
Marasmius_haematocephalus	NA
Marasmius_plicatilis	NA
Marasmius_sp-b	NA
Marasmius_sp-c	NA
Marasmius_sp-d	NA
Marasmius_sp-e	NA
Marasmius_sp-f	NA
Marasmius_sp-g	NA
Marasmius_sp-h	NA
Marasmius_sp-i	NA
Marasmius_sp-j	NA
Marasmius_sp-k	NA
Marasmius_sp-l	NA
Marasmius_sp-m	NA
Marasmius_sp-n	NA
Marasmius_sp	NA
Marasmius_zenkeri	NA
Merulius_incarnatus	NA
Merulius_tremelloides	NA
Microglossum_rufum	NA
Microglossum_viride	NA
Montagnea_arenaria-c	NA
Montagnea_arenaria	NA
Morcella_esculenta	NA
Morchella_angusticeps	0
Morchella_elata-b	NA
Morchella_elata-c	NA
Morchella_elata-d	NA
Morchella_elata-e	NA
Morchella_elata-f	NA
Morchella_elata-g	NA
Morchella_elata	0
Morchella_esculenta-h	NA
Morchella_esculenta-i	NA
Morchella_esculenta-j	NA
Morchella_esculenta-k	NA
Morchella_esculenta-l	NA
Morchella_esculenta-m	NA
Morchella_esculenta-n	NA
Morchella_esculenta-o	NA
Morchella_esculenta-p	NA
Morchella_esculenta	0
Morchella_semilibera	0
Morchella_sp	NA
Morchella_tomentosa-b	NA
Morchella_tomentosa	0
Morchella_tulipifera	NA
Mucronella_alba	NA
Mucronella_calva	NA
Mushroom_Mix	NA
Mutinus_bambusinus	NA
Mutinus_sp	NA
Mycena_chlorophos-b	NA
Mycena_chlorophos	NA
Mycena_deusta-b	NA
Mycena_deusta-c	NA
Mycena_deusta	NA
Mycena_fera	NA
Mycena_haematopus	NA
Mycena_interrupta-b	NA
Mycena_interrupta-c	NA
Mycena_interrupta-d	NA
Mycena_interrupta	NA
Mycena_leaiana-b	NA
Mycena_leaiana-c	NA
Mycena_leaiana-d	NA
Mycena_leaiana	NA
Mycena_nargan	NA
Mycena_overholtsii	NA
Mycena_purpureofusca	NA
Mycena_sp-b	NA
Mycena_sp-c	NA
Mycena_sp-d	NA
Mycena_sp-e	NA
Mycena_sp	NA
Mycena_spinosissima	NA
Mycena_tapeina	NA
Mycena_viscidocruenta-b	NA
Mycena_viscidocruenta	NA
Nidula_sp	NA
Omphalotus_illudens-b	NA
Omphalotus_illudens-c	NA
Omphalotus_illudens	1
Omphalotus_japonicus	1
Omphalotus_nidiformis-b	NA
Omphalotus_nidiformis-c	NA
Omphalotus_nidiformis	1
Omphalotus_subilludens	NA
Oudemansiella_canarii	NA
Oudemansiella_mucida-b	NA
Oudemansiella_mucida-c	NA
Oudemansiella_mucida-d	NA
Oudemansiella_mucida	NA
Panellus_longinquus	NA
Panus_conchatus-b	NA
Panus_conchatus	NA
Paurocotylis_pila	NA
Paxillus_atrotomentosus-b	NA
Paxillus_atrotomentosus-c	NA
Paxillus_atrotomentosus	NA
Penicillopsis_clava	NA
Perenniporia_martiusii	NA
Peziza_violacea	NA
Phaeolepiota_aurea	NA
Phaeolus_schweinitzii	NA
Phallus_callichrous-b	NA
Phallus_callichrous-c	NA
Phallus_callichrous	NA
Phallus_impudicus-b	NA
Phallus_impudicus	0
Phallus_indusiatus	0
Phallus_merulinus	NA
Phallus_ravenelii	NA
Phillipsia_domingensis-b	NA
Phillipsia_domingensis	NA
Phlebopus_sp	NA
Phlogiotis_helvelloides-b	NA
Phlogiotis_helvelloides	NA
Pholiota_destruens-bZ	NA
Pholiota_destruens	NA
Pholiota_flammans-b	NA
Pholiota_flammans	NA
Pholiota_sp	NA
Pholiota_squarrosa-b	NA
Pholiota_squarrosa-c	NA
Pholiota_squarrosa-d	NA
Pholiota_squarrosa	NA
Phylloporus_rhodoxanthus	0
Phyllotopsis_nidulans	NA
Pisolithus_tinctorius-b	NA
Pisolithus_tinctorius-c	NA
Pisolithus_tinctorius	NA
Pleurocybella_porrigens-b	NA
Pleurocybella_porrigens-c	NA
Pleurocybella_porrigens-d	NA
Pleurocybella_porrigens	0
Pleurotus_citrinopileatus	0
Pleurotus_djamor-b	NA
Pleurotus_djamor-c	NA
Pleurotus_djamor	0
Pleurotus_eryngii	0
Pleurotus_ostreatus-b	NA
Pleurotus_ostreatus-c	NA
Pleurotus_ostreatus-d	NA
Pleurotus_ostreatus-e	NA
Pleurotus_ostreatus	0
Pleurotus_serotinus-b	NA
Pleurotus_serotinus	NA
Pleurotus_sp	NA
Pleurotus_tuber-regium-b	NA
Pleurotus_tuber-regium-c	NA
Pleurotus_tuber-regium	0
Pluteus_atromarginatus	NA
Pluteus_sp	NA
Pluteus_thomsonii	NA
Podaxis_beringamensis-b	NA
Podaxis_beringamensis	NA
Podoscypha_petaloides-b	NA
Podoscypha_petaloides	NA
Podoserpula_pusio-b	NA
Podoserpula_pusio-c	NA
Podoserpula_pusio-d	NA
Podoserpula_pusio	NA
Podostroma_cornu-damae-b	NA
Podostroma_cornu-damae	1
Polyozellus_multiplex	1
Polyporus_arcularius	NA
Polyporus_curitpes	NA
Polyporus_guianensis-b	NA
Polyporus_guianensis	NA
Polyporus_sp	NA
Polyporus_squamosus-b	NA
Polyporus_squamosus-c	NA
Polyporus_squamosus-d	NA
Polyporus_squamosus	NA
Polyporus_squamosus_neg	NA
Polyporus_tenuiculus-b	NA
Polyporus_tenuiculus-c	NA
Polyporus_tenuiculus-d	NA
Polyporus_tenuiculus	NA
Poronia_gigantea	NA
Psathyrella_delineata	NA
Pseudocolus_fusiformis	NA
Pseudocolus_schellen	NA
Pseudohydnum_gelatinosum-b	NA
Pseudohydnum_gelatinosum-c	NA
Pseudohydnum_gelatinosum-d	NA
Pseudohydnum_gelatinosum-e	NA
Pseudohydnum_gelatinosum	0
Psilocybe_cubensis-b	NA
Psilocybe_cubensis	NA
Psilocybe_cyanescens	NA
Psilocybe_sp	NA
Psilocybe_squamosa	NA
Pterula_subulata	NA
Pulcherricium_caeruleum	NA
Pulveroboletus_auri	NA
Pycnoporus_coccineus	NA
Pynconoporus_sp	NA
Ramaria_araiospora-b	NA
Ramaria_araiospora-c	NA
Ramaria_araiospora-d	NA
Ramaria_araiospora	0
Ramaria_moelleriana	NA
Ramaria_sp-b	NA
Ramaria_sp-c	NA
Ramaria_sp-d	NA
Ramaria_sp-e	NA
Ramaria_sp-f	NA
Ramaria_sp-h	NA
Ramaria_sp	NA
Ramariopsis_kunzei-b	NA
Ramariopsis_kunzei	0
Roridomyces_sp-b	NA
Roridomyces_sp	NA
Rozites_caperata	NA
Russula_crustosa	0
Russula_sp-b	NA
Russula_sp	NA
Sarcodon_bambusinus	NA
Sarcodon_imbricatus	0
Sarcodon_sp	NA
Sarcoscypha_coccinea-b	NA
Sarcoscypha_coccinea-c	NA
Sarcoscypha_coccinea	NA
Schizophyllum_commune-b	NA
Schizophyllum_commune-c	NA
Schizophyllum_commune-d	NA
Schizophyllum_commune-e	NA
Schizophyllum_commune-f	NA
Schizophyllum_commune-g	NA
Schizophyllum_commune	1
Scleroderma_citrinum	1
Scutellinia_scutellata	NA
Slime_mold-b	NA
Slime_mold	NA
Sparassis_crispa-b	NA
Sparassis_crispa	NA
Spathularia_flavida-b	NA
Spathularia_flavida	NA
Spathularia_velutipes-b	NA
Spathularia_velutipes	NA
Spinellus_sp	NA
Staheliomyces_cinctus-b	NA
Staheliomyces_cinctus	NA
Stemonitis_axifera	NA
Stemonitis_sp	NA
Stipitochaete_damicornis	NA
Strobilomyces_confusus-b	NA
Strobilomyces_confusus	NA
Strobilomyces_floccopus	NA
Stropharia_aeruginosa-b	NA
Stropharia_aeruginosa-c	NA
Stropharia_aeruginosa-d	NA
Stropharia_aeruginosa	1
Stropharia_ambigua-c	NA
Stropharia_ambigua	NA
Stropharia_ambigua_-bZ	NA
Stropharia_coronilla	NA
Suillus_cavipes	0
Suillus_grevillei	0
Suillus_grevillei_-bZ	NA
Suillus_lakeii	NA
Suillus_ochraceoroseus	0
Termitomyces_microcarpus	NA
Termitomyces_striatus	NA
Tetrapyrgos_nigripe-b	NA
Tetrapyrgos_nigripes	NA
Thaxterogaster_porphyreum	NA
Trametes_versicolor	NA
Tremella_fuciformis-b	NA
Tremella_fuciformis-c	NA
Tremella_fuciformis-d	NA
Tremella_fuciformis	0
Tremella_mesenterica	0
Tremella_reticulata	NA
Trichaptum_abietinum	NA
Trichocoma_paradoxa-b	NA
Trichocoma_paradoxa	NA
Tricholoma_bakamatsutake	0
Tricholoma_magnivelare-b	NA
Tricholoma_magnivelare-c	NA
Tricholoma_magnivelare	0
Tricholoma_pardinum	1
Tricholomopsis_decora-b	NA
Tricholomopsis_decora	NA
Tricholomopsis_sp	NA
Trogia_sp-b	NA
Trogia_sp	NA
Tylopilus_plumbeoviolaceus	NA
Vanromburghia_sp	NA
Verpa_bohemica	0
Volvariella_bombycina	0
WMF	NA
Weraroa_erythrocephala	NA
Weraroa_virescens	NA
Xeromphalina_campanella-b	NA
Xeromphalina_campanella-c	NA
Xeromphalina_campanella	0
Xerula_furfuracea	NA
Xylaria_hypoxylon-b	NA
Xylaria_hypoxylon	NA
Xylaria_tentaculata	NA
